Němčina | Čeština
učebnice strana 50 a 51
der Absolvent - absolvent
sich ändern - měnit se
der Arbeitsmarkt - trh práce
aus/üben - vykonávat
der Bereich - obor
betreffen - týkat se
die Branche - obor
entlassen - propustit
die Entwicklung - vývoj
ersetzen - nahradit
fort/setzen etwas - pokračovat v něčem
gelten - platit
sich gewöhnen an jemanden/etwas - zvyknout si, zvykat si na někoho/něco
die Industrie - průmysl
die Investition - investice
kündigen - dát výpověď
der Mangel an etwas - nedostatek něčeho
der Pfleger - ošetřovatel
der Roboter - robot
die Tätigkeit - činnost
versprechen - slíbit, slibovat
der Wandel - změna, obrat
zukünftig - budoucí

učebnice strana 52 a 53
das Alter - věk, stáří
der Arbeitgeber - zaměstnavatel
das Bedürfnis - potřeba
bereit - připravený
die Betreuung - ošetřování, opatrování
der Bewohner - obyvatel
die Einrichtung - zařízení
das Engagement - nasazení, angažmá
die Fähigkeit - schopnost
die Fortbildung - další vzdělávání
das Heim - domov
die Kenntnis - znalost
kommunikativ - komunikativní
leiten - vést
respektieren - respektovat
sich richten - řídit se
die Schicht - směna
üblich - obvyklý; obvykle
der Vertrag - smlouva
die Zusammenarbeit - spolupráce
zuständig für etwas - (z)odpovědný za něco

učebnice strana 54
der Abschluss - ukončení, konec
die Anlage - příloha (e-mailu)
die Behörde - úřad
die Beratung - (po)rada
geeignet - vhodný
gestrig - včerejší
informativ - informativní
die Integration - integrace
kegeln - hrát kuželky
der Lebenslauf - životopis
motivieren - motivovat
der Optimismus - optimismus
die Verantwortung - odpovědnost
zuverlässig - spolehlivý

učebnice strana 54
der Arbeitnehmer - zaměstnance
der Auftrag - zakázka, objednávka
der Austausch - výměna
befürchten - obávat se
der Bekannte - znýmý
ein/teilen - rozdělit
der Elternurlaub - mateřská dovolená
erscheinen - objevit se
teilweise - částečně
überflüssig - zbytečný; zbytečně
wechseln - měnit, změnit

učebnice strana 56 a 57
brennen - hořet, pálit
ein/schlafen - usnout
die Evakuieren - evakuace
der Himmel - nebe
die Landung - přistání
nobel - ušlechtilý, noblesní
die Not - nouze
die Panik - panika
der Passagier - cestující
schreien - křičet
starten - startovat
die Übung - cvičení
der Urgroßvater - pradědeček
wahr - pravdivý, skutečný
weither - zdaleka

učebnice strana 58
arbeitslos - nezaměstnaný
beides - oboje
fest - pevý; pevně
der Immigrant - imigrant
der Unterschied - rozdíl
